11111
1PC01
1C1C1
1C1E1
11111
