111111111111111111111111111111111111111111111111111111111111111111111111111111111111111111
10P000E00100000000000000010000000000000000000000000000000000000011000000000000000000000001
100000000100000000000000000000000000000000000000000000000000001100000000000000000000000001
100CC0000000000010000000011111000000000000000000000000000000110000000000000000000000000001
100000000100000000000000000000000000000000000000000000000110000000000000000000000000000001
100000000100000000000000000000000000000000000000000000001001000000000000000000000000000001
100000010000000100000000000000000000000000000000000000110000000000000000000000000000000001
111111111000000000000000000001000000000000000000000011000000000000000000000000000000000001
100000000100000000000000010000000000000000000000001100000000000000000000000000000000000001
100000000100000000000000000100000000000000000000110000000000000000000000000000000000000001
100000000000000000000000011111000000000000000011000000000000000000000000000000000000000001
100000000100000000000000000000000000000000001100000000000000000000000000000000000000000001
100000000100000000000000000000000000000000110000000000000000000000000000000000000000000001
100000000000000000000000000000000000000011000000000000000000000100000000000000000000000001
111110000000000000000000000001000000110000000000000000000000000000000000000000000000000001
100000000100000000000000000000000000001100000000000000000000000000000000000000000000000001
100000000100000000000000000000000000000000000000000000000000000000000000000000001100000001
100000000000000000000000000000000000000000000000000000000000000000000000000000110000000001
111111111000000000000000000001000000000000000000000000000000000000000000000011000000000001
100000000100000000000000010000000000000000000000000000000000000000000000001100000000000001
100000000100000000000000000100000000000000000000000000000000000000000000110000000000000001
100000000000000000000000011111000000000000000000000000000000000000000011000000000000000001
100000000100000000000000000000000000000000000000000000000000000000001100000000000000000001
100000000100000000000000000000000000000000000000000000000000000000110000000000000000000001
100000000000000000000000000000000000000000000000000000000000000011000000000000000000000001
100000000100000000000000000000000000000000000000000000000000001100000000000000000000000001
100000000100000000000000000000000000000000000000000000000000110000000000000000000000000001
100000000000000000000000000000000000000000000000000000000011000000000000000000000000000001
111110000000000000000000000001000000000000000000000000001100000000000000000000000000000001
100000000100000000000000000000000000000000000000000000110000000000000000000000000000000001
100000000100000000000000000000000000000000000000000011000000000000000000000000000000000001
100000000000000000000000000000000000000000000000001100000000000000000000000000000000000001
111111111000000000000000000000000000000000000000110000000000001000000000000000000000000001
100000000100000000000000010000000000000000000000000000000000000001100000000000000000000001
100000000000000000000000000000000000000010000000000000000010000110000000000000000000000001
100000000000000000000000011110000000000000000000000000000000111011000000000000000000000001
100000000100000000000000000000000000000000000000000000000001100000000000000000000000000001
100000000100000000000000000000000000000000000000000000000110000000000000000000000000000001
100000000000000000000000000000000000000000000000000000011000000000000000000000000000000001
110000000000000000000000000000000000000000000000000001100001111000000000000000000000000001
100000000100000000000000000000000000000000000000000110000000000000000000000000000000000001
100000000100000000000000000000000000000000000000011000000000000000000000000000000000000001
100000000000000000000000000000000000000000000001100000000000000000000000000000000000000001
111111111000000000000000000000000000000000000110000000000000001000000000000000000000000001
100000000100000000000000000000000000000000011000000000000010000000000000000000000000000001
100000000100000000000000000100000000000000000000000000000000000000000000001100000000000001
100000000000000000000000000000000000000000000000000000001111100000000000010010000000000001
100000000100000000000000000000000000000000000000000000000000000000000000100000000000000001
100000000100000000000000000000000000000000000000000000000010000000000000000000000000000001
100000000000000000000000000000000000000000000000000000000000000000000000000000000000000001
100000000000000000000000000000000000000000000000000000000000000000000000000000000000000001
111111111111111111111111111111111111111111111111111111111111111111111111111111111111111111
