11111
1PC01
1C011
1C1E1
11111
